666666666666666666666666666
600000000000000000000000006
600000000000000000000000006
600000322312000000111000006
600000300000000002000100006
600000300000000000100000006
600000311111000020030000006
600000000000000001002000006
600000000000000000100000006
644444444444444444444444006
600000000000000000000000006
600000211100000001234500006
600000200010000010000200006
600000000010000010000200006
600000200010000010000200006
600000200010000010000200006
600000211110000010000200006
600000000000000000000000006
600000000000000000000000006
666666666666666666666666666
