666666666666666666666666666
600000000000000000000000006
600000000000000000000000006
600000300001000000000000006
600000300001000001345000006
600000322221000001000100006
600000311111000001222100006
600000300001000001000100006
600000300001000001111000006
644444444444444444444444006
600000000000000000000000006
600000111110000011111000006
600000100000000000200000006
600000111110000000200000006
600000000010000000200000006
600000000010000000200000006
600000111110000011211000006
600000000000000000000000006
600000000000000000000000006
666666666666666666666666666
